000000000000000000000000
000000000000000000000000
000000000000000000000000
011000111000000011000000
011020000000000000000000
011110000000110000000110
011110000011000000000000
011000010111100011001100
000000010111100011001110
000001110111111011011110
111111110111111011011110